######
#A  ##
# @ o#
# @ o#
######

