########
#o   A #
#   @  #
#      #
########
