#########
#      o#
# @@   o#
#A      #
#########
