###
#o#####
#o   o#
# @@@A#
#    ##
######