########
#o @ ###
#### @o#
####A###
####@#
   #o#
   ###
