 #####
 #   ####
 #   #  #
 ##    o#
### ###o#
# @ # #o#
# @@# ###
#A  #
#####
