#####
#o o#
# @@#
#  A#
#####
