###########
###########
###########
#      o o#
# @@#######
#A  #
#####
