  #######
  #     #
  # @ A #
##### # #
# @     #
#  #@## ##
#oo@  #  #
#oo      #
##########