#######
###o###
###@ ###
###  @o#
#o @A###
####@#
   #o#
   ###