 #####
 #   ####
 #   #  #
 ##     #
### ###o#
# @ # #o#
# @ # ###
#A  #
#####
